def1 = 1
def2 = 2
sit = down
able =  có năng lực; có tài;
abandon =  bỏ; từ bỏ;
about = khoảng; về;
act = hành động; hành vi; cử chỉ; đối xử;
afraid = sợ; sợ hãi; hoảng sợ;
after = sau; đằng sau; sau khi;
ask = hỏi;
at = ở tại (chỉ vị trí);
atom = nguyên tử;
bear = mang; cầm; vác; đeo; ôm;
beat = tiếng đập; sự đập; đánh đập; đấm;
beauty = vẻ đẹp; cái đẹp; người đẹp;
bed = cái giường;
been = thì; là;
before = trước; đằng trước;
began = bắt đầu; mở đầu; khởi đầu;
begin = bắt đầu; khởi đầu;
behind = sau; ở đằng sau;
believe = tin; tin tưởng;
call = gọi; tiếng kêu; tiếng gọi;
came = khung chì (để) lắp kinh (cửa);
camp = trại; chỗ cắm trại; cắm trại; hạ trại;
can = có thể; nhà tù; nhà giam; bình;
capital = thủ đô; tiền vốn; chủ yếu; chính yếu; cơ bản;
captain = người cầm đầu; người chỉ huy; thủ lĩnh;
car = xe hơi;
card = thẻ; thiếp;
care = sự chăm sóc; chăm nom; chăm sóc;
carry = mang; vác; khuân chở;
case = vỏ; ngăn; túi;
cat = con mèo;
catch = bắt lấy; nắm lấy; tóm lấy; chộp lấy;
caught; sự bắt; sự nắm lấy; cái bắt; cái vồ; cái chộp;
cause = nguyên nhân; nguyên do; gây ra; gây nên;
cell = ô; ngăn;
dad = bố; cha;
dance = sự nhảy múa; sự khiêu vũ; nhảy múa; khiêu vũ;
danger = sự nguy hiểm; mối hiểm nghèo; nguy cơ; mối đe dọa;
dark = tối; tối tăm; bóng tối; ám muội;
day = ngày; ban ngày;
dead = chết; tắt;
deal = phân phát; phân phối; sự giao dịch; thỏa thuận mua bán;
dear = thân; thân yêu; thân mến; kính thưa; thưa;
death = sự chết; cái chết;
decide = quyết định; giải quyết; phân xử;
decimal = thập phân;
deep = sâu; khó lường; bí ẩn;
degree = mức độ; trình độ; bằng cấp; độ;
depend = phụ thuộc; tuỳ thuộc; tuỳ thuộc;
describe = diễn tả; miêu tả; mô tả;
desert = sa mạc; công lao; giá trị; rời bỏ; bỏ trốn;
design = sự thiết kế; kế hoạch; đề cương. phác thảo; phác họa; thiết kế;
determine = xác định; định rõ; quyết định;
develop = phát triển; mở rộng; trình bày; bày tỏ;
dictionary = từ điển;
die = chết; từ trần; hy sinh;
differ = khác; không giống;
difficult = khó; khó khăn; gay go;
direct = trực tiếp; thẳng; thẳng thắn; gửi; viết cho ai; điều khiển;
discuss = thảo luận; tranh luận;
distant = xa; cách; xa cách;
divide = chia; chia ra; phân ra;
division = sự chia; sự phân chia; sự phân loại;
doctor = bác sĩ y khoa; tiến sĩ;
doe =; hươu cái; hoãng cái; nai cái;
dog = chó;
dollar = đô la Mỹ;
done = xong; hoàn thành; đã thực hiện;
door = cửa; cửa ra vào;
double = đôi; hai; kép; cái gấp đôi; lượng gấp đôi; làm gấp đôi;
down = xuống;
draw = vẽ; kéo;
dream = giấc mơ; mơ;
dress = quần áo; mặc (quần áo); ăn mặc;
drink = đồ uống; uống;
drive = lái; đua xe; cuộc đua xe (điều khiển);
drop = chảy nhỏ giọt; rơi; rớt; giọt (nước; máu...);
dry = khô; cạn; làm khô; sấy khô;
duck = con vịt; vịt cái;
during = trong lúc; trong thời gian;
energy = năng lượng; nghị lực; sinh lực;
engine = máy; động cơ;
enough = đủ;
enter = đi vào; gia nhập;
equal = ngang; bằng; người ngang hàng; ngang tài; sức; bằng; ngang;
equate = làm cân bằng; san bằng;
especially = đặc biệt là; nhất là;
even = ngay cả; ngay; lại còn; bằng phẳng; điềm đạm; ngang bằng;
evening = buổi chiều; tối;
event = sự việc; sự kiện;
ever = từng; từ trước tới giờ;
every = mỗi; mọi;
exact = chính xác; đúng;
example = thí dụ; ví dụ;
except = trừ ra; không kể; trừ phi;
excite = kích thích; kích động;
exercise = bài tập; sự thi hành; sự thực hiện; làm; thi hành; thực hiện;
expect = chờ đợi; mong ngóng; liệu trước;
experience = kinh nghiệm; trải qua; nếm mùi;
experiment = cuộc thí nghiệm; thí nghiệm;
face = mặt; thể diện; đương đầu; đối phó; đối mặt;
fact = việc; sự việc; sự kiện;
fair = hợp lý; công bằng; thuận lợi;
fall = rơi; ngã; sự rơi; ngã;
family = gia đình; thuộc gia đình;
famous = nổi tiếng;
far = xa;
farm = trang trại;
fast = nhanh;
fat = béo; béo bở; mỡ; chất béo;
father = cha (bố);
favor = thiện ý; sự quý mến;
fear = sự sợ hãi; e sợ; sợ; lo ngại;
feed = cho ăn; nuôi;
feel = cảm thấy;
feet = chân; bàn chân (người; thú...);
fell = da lông (của thú vật);
felt = nỉ; phớt;
few = ít; vài; một ít; một vài;
field = cánh đồng; bãi chiến trường;
fig = quả sung; quả vả;
fight = đấu tranh; chiến đấu; sự đấu tranh; cuộc chiến đấu;
figure = hình dáng; nhân vật; hình dung; miêu tả;
fill = làm đấy; lấp kín;
final = cuối cùng; cuộc đấu chung kết;
find = tìm; tìm thấy;
fine = tốt; giỏi;
finger = ngón tay;
finish = kết thúc; hoàn thành; sự kết thúc; phần cuối;
fire = lửa; đốt cháy;
first = thứ nhất; đầu tiên; trước hết; người; vật đầu tiên; thứ nhất;fuck = phắc du
fuck = phắc
game = trò chơi;
garden = vườn;
gas = khí; hơi đốt;
gather = tập hợp; hái; lượm; thu thập;
gave = cho; biếu; tặng; ban;
general = chung; chung chung; tổng;
gentle = hiền lành; dịu dàng; nhẹ nhàng;
get = được; có được;
girl = con gái;
give = cho; biếu; tặng;
glad = vui lòng; sung sướng;
glass = kính; thủy tinh; cái cốc; ly;
go = đi;
gold = vàng; bằng vàng;
gone = đã đi; đã đi khỏi; đã trôi qua; đã qua;
good = tốt; hay; tuyệt; điều tốt; điều thiện;
had = có;
hair = tóc;
half = một nửa; phần chia đôi; nửa giờ; nửa;
hand = tay; bàn tay; trao tay; truyền cho;
happen = xảy ra; xảy đến;
happy = vui sướng; hạnh phúc;
hard = cứng; rắn; hà khắc; hết sức cố gắng; tích cực;
has = có;
hat = cái mũ;
have = có;
he = nó; anh ấy; ông ấy;
head = cái đầu (người thú); chỉ huy; lãnh đại; dẫn đầu;
hear = nghe;
heard = nghe;
heart = tim; trái tim;
heat = hơi nóng; sức nóng;
heavy = nặng; nặng nề;
held = khoang (của tàu thuỷ);
help = giúp đỡ; sự giúp đỡ;
her = nó; chị ấy; cô ấy; bà ấy;
here = đây; ở đây;
high = cao; ở mức độ cao;
hill = (n.) đồi;
him = nó; hắn; ông ấy; anh ấy;
hololive = THIS IS HOLOLIVE
ice = băng; nước đá;
idea = ý tưởng; quan niệm;
if = nếu; nếu như;
imagine = tưởng tượng; hình dung; tưởng rằng; cho rằng;
in = ở; tại; trong; vào;
inch = insơ (đơn vị đo chiều dài Anh bằng 2; 54 cm);
include = bao gồm; tính cả;
indicate = chỉ; cho biết; biểu thị; trình bày ngắn gọn;
industry = công nghiệp; kỹ nghệ;
insect = sâu bọ; côn trùng;
instant = lúc; chốc lát;
instrument = dụng cụ âm nhạc khí;
interest = sự thích thú; sự quan tâm; chú ý; làm quan tâm; làm chú ý;
invent = phát minh; sáng chế;
iron = sắt; bọc sắt;
island = hòn đảo;
it = cái đó; điều đó; con vật đó;
job = việc; việc làm;
join = gia nhập; tham gia; nối; chắp; ghép;
joy = niềm vui; sự vui mừng;
jump = nhảy; sự nhảy; bước nhảy;
just = đúng; vừa đủ; vừa mới; chỉ;
keep = giữ; giữ lại;
kept = giữ; giữ lại;
key = chìa khóa; khóa; thuộc (khóa);
kill = giết; tiêu diệt;
kind = loại; giống; tử tế; có lòng tốt;
kinh = vua; quốc vương;
knew = biết; hiểu biết;
know = biết;
lady = người yêu; vợ; quý bà; tiểu thư;
lake = hồ;
land = đất; đất canh tác; đất đai;
language = ngôn ngữ;
large = rộng; lớn; to;
last = lầm cuối; sau cùng; người cuối cùng; cuối cùng; rốt hết; kéo dài;
late = trễ; muộn;
laugh = cười; tiếng cười;
law = luật;
lay = xếp; đặt; bố trí;
lead = lãnh đạo; dẫn dắt; sự lãnh đạo; sự hướng dẫn;
learn = học; nghiên cứu;
least = tối thiểu; ít nhất;
leave = bỏ đi; rời đi; để lại;
left = bên trái; về phía trái;
leg = chân (người; thú; bàn...);
length = chiều dài; độ dài;
less = (det.; pron.; adv.) nhỏ bé; ít hơn; số lượng ít hơn;
let = cho phép; để cho;
letter = thư; chữ cái; mẫu tự;
level = trình độ; cấp; vị trí; bằng; ngang bằng;
lie = nói dối; lời nói dối; sự dối trá;
life = đời; sự sống;
lift = giơ lên; nhấc lên; sự nâng; sự nhấc lên;
light = ánh sáng; nhẹ; nhẹ nhàng; đốt; thắp sáng;
like = giống như; thích; như;
line = dây; đường; tuyến;
liquid = chất lỏng; lỏng; êm ái; du dương; không vững;
machine = máy; máy móc;
made = làm; hoàn thành; thực hiện;
magnet = nam châm;
main = chính; chủ yếu; trọng yếu nhất;
major = lớn; nhiều hơn; trọng đại; chủ yếu;
make = làm; chế tạo; sự chế tạo;
man = con người; đàn ông;
many = nhiều;
map = bản đồ;
mark = dấu; nhãn; nhãn mác; đánh dấu; ghi dấu;
market = chợ; thị trường;
mass = khối; khối lượng; quần chúng; đại chúng;
master = chủ; chủ nhân; thầy giáo; thạc sĩ;
match = trận thi đấu; đối thủ; địch thủ; đối chọi; sánh được;
material = nguyên vật liệu; vật chất; hữu hình;
matter = chất; vật chất; có ý nghĩa; có tính chất quan trọng;
may = tháng 5;
me = tôi; tao; tớ;
mean = nghĩa; có nghĩa là;
meant = khoảng giữa; trung độ; trung gian; trung dung;
measure = đo; đo lường; sự đo lường; đơn vị đo lường;
meat = thịt;
meet = gặp; gặp gỡ;
name = tên; đặt tên; gọi tên;
nation = dân tộc; quốc gia;
natural = (thuộc) tự nhiên; thiên nhiên;
nature = tự nhiên; thiên nhiên;
near = gần; cận; ở gần;
necessary = cần; cần thiết; thiết yếu;
neck = cổ;
need = cần; đòi hỏi; sự cần;
never = không bao giờ; không khi nào;
new = mới; mới mẻ; mới lạ;
next = sát; gần; bên cạnh; lần sau; tiếp nữa;
night = đêm; tối;
niên = chín;
no = không;
noise = tiếng ồn; sự huyên náo;
noon = trưa; buổi trưa;
nor = cũng không;
north = phía bắc; phương bắc;
nose = mũi;
note = lời ghi; lời ghi chép; ghi chú; ghi chép;
nothing = không gì; không cái gì;
notice = thông báo; yết thị; chú ý; để ý; nhận biết;
noun = (ngôn ngữ học) danh t;
now = bây giờ; hiện giờ; hiện nay;
number = số;
numeral = (thuộc) số;
object = vật; vật thể; phản đối; chống lại;
observe = quan sát; theo dõi;
occur = xảy ra; xảy đến; xuất hiện;
ocean = đại dương;
of = của;
off = tắt; khỏi; cách; rời;
offer = biếu; tặng; cho; sự trả giá;
office = cơ quan; văn phòng; bộ;
often = thường; hay; luôn;
oh = chao; ôi chao; chà; này..;
oil = dầu;
old = già;
on = trên; ở trên; tiếp tục; tiếp diễn;
once = một lần; khi mà; ngay khi; một khi;
one = (number; det.; pron.) một; một người; một vật nào đó;
only = chỉ có 1; duy nhất; chỉ; mới;
open = mở; ngỏ; mở; bắt đầu; khai mạc;
operate = hoạt động; điều khiển;
opposite = đối nhau; ngược nhau; trước mặt; đối diện; điều trái ngược;
page = trang (sách);
paint = sơn; vôi màu; sơn; quét sơn;
pair = đôi; cặp;
paper = giấy;
paragraph = đoạn văn;
parent = cha; mẹ;
part = phần; bộ phận;
particular = riêng biệt; cá biệt;
party = tiệc; buổi liên hoan; đảng;
pass = qua; vượt qua; ngang qua;
past = quá khứ; dĩ vãng; quá; qua;
path = đường mòn; hướng đi;
pattern = mẫu; khuôn mẫu;
pay = trả; thanh toán; nộp; tiền lương;
people = dân tộc; dòng giống; người;
perhaps = có thể; có lẽ;
period = kỳ; thời kỳ; thời gian; thời đại;
person = con người; người;
phrase = câu; thành ngữ; cụm từ;
pick = đào; khoét (lỗ);
Picture = bức vẽ; bức họa;
piece = mảnh; mẩu; đồng tiền;
pitch = sân (chơi các môn thể thao); đầu hắc ín;
quart = góc tư galông; lít Anh (bằng 1; 135 lít);
question = câu hỏi; hỏi; chất vấn;
quick = nhanh;
quiet = lặng; yên lặng; yên tĩnh;
quite = hoàn toàn; hầu hết;
quotient = (toán học) số thương;
race = loài; chủng; giống; cuộc đua; đua;
radio = sóng vô tuyến; radio;
rail = đường ray;
rain = mưa; cơn mưa; mưa;
raise = nâng lên; đưa lên; ngẩng lên;
ran = chạy;
range = dãy; hàng; loại; phạm vi; trình độ;
rather = thà.. còn hơn; thích... hơn;
reach = đi đến; tới;
read = đọc;
ready = sẵn sàng;
real = thực; thực tế; có thật;
reason = lý do; lý lẽ;
receive = nhận; lĩnh; thu;
record = bản ghi; sự ghi; bản thu; sự thu; thu; ghi chép;
red = đỏ; màu đỏ;
region = vùng; miền;
remember = nhớ; nhớ lại;
repeat = nhắc lại; lặp lại;
reply = sự trả lời; sự hồi âm; trả lời; hồi âm;
represent = miêu tả; hình dung; đại diện; thay mặt;
require = đòi hỏi; yêu cầu; quy định;
safe = an toàn; chắc chắn; đáng tin;
said = vải chéo;
sail = đi tàu; thuyền; nhổ neo; buồm; cánh buồm; chuyến đi bằng thuyền buồm;
salt = muối;
same = đều đều; đơn điệu; cũng như thế; vẫn cái đó;
sand = cát;
sat = ngồi;
save = cứu; lưu;
saw = tục ngữ; cách ngôn;
say = nói;
scale = vảy (cá..);
school = đàn cá; bầy cá;
science = khoa học; khoa học tự nhiên;
score = điểm số; bản thắng; tỷ số; đạt được; thành công; cho điểm;
sea = biển;
search = sự tìm kiếm; sự thăm dò; sự điều tra; tìm kiếm; thăm dò; điều tra;
season = mùa;
seat = ghế; chỗ ngồi;
second = thứ hai; ở vị trí thứ 2; thứ nhì; người về nhì;
section = mục; phần;
see = nhìn; nhìn thấy; quan sát;
under = dưới; ở dưới; ở phía dưới; về phía dưới;
unit = đơn vị;
until = trước khi; cho đến khi;
up = ở trên; lên trên; lên;
us = chúng tôi; chúng ta; tôi và anh;
use = sử dụng; dùng; sự dùng; sự sử dụng;
usual = thông thường; thường dùng;
valley = (n.) thung lũng;
value = giá trị; ước tính; định giá;
vary = thay đổi; làm cho khác nhau; biến đổi;
verb = động từ;
very = rất; lắm;
view = sự nhìn; tầm nhìn; nhìn thấy; xem; quan sát;
village = làng; xã;
visit = đi thăm hỏi; đến chơi; tham quan; sự đi thăm; sự thăm viếng;
voice = tiếng; giọng nói;
vowel = (ngôn ngữ học) nguyên âm;
wait = chờ đợi;
walk = đi; đi bộ; sự đi bộ; sự đi dạo;
wall = tường; vách;
want = muốn;
war = chiến tranh;
warm = ấm; ấm áp; làm cho nóng; hâm nóng;
was = thì; là;
wash = rửa; giặt;
watch = nhìn; theo dõi; quan sát; sự canh gác; sự canh phòng;
water = nước;
wave = sóng; gợn nước; gợn sóng; uốn thành sóng;
Yard = thước Anh (bằng 0; 914 mét);
year = năm;
yellow = vàng;
yes = vâng; phải; dạ; được; ừ; có; có chứ;
yet = còn; hãy còn; còn nữa;
you = anh; chị; ông; bà; ngài; ngươi; mày; các anh; các chị; các ông; các bà; các ngài;
young = trẻ; trẻ tuổi; thiếu niên; thanh niên;
your = của anh; của chị; của ngài; của mày; của các anh; của các chị; của các ngài; của;
add = cộng thêm
